trouble and strife  —  жена, спутница жизни
maple syrup  —  кленовый сироп
a glass of lemonade  —  стакан лимонада
delicious meal  —  вкусная еда
dry sherry  —  сухой херес
a piece of rye bread  —  кусочек ржаного хлеба
a cup of cappuccino  —  чашка капучино
to charge  —  заряжать
to strike  —  ударять, бить
electric field  —  электрическое поле
to resist  —  оказывать сопротивление
fuel consumption  —  потребление топлива
to cause damage  —  наносить ущерб, повреждение
lightning strike  —  удар молнии
aircraft design  —  дизайн самолета
to reduce the weight  —  уменьшить вес
to affect  —  воздействовать
upside down  —  вверх ногами
to recognize  —  распознавать
to keep track  —  отслеживать
to be confused  —  быть в замешательстве
to process information  —  обрабатывать информацию
to examine  —  проверять
to influence  —  влиять
to explore  —  исследовать
selective attention  —  избирательное внимание
words meaning  —  значения слов
color-naming effect  —  эффект колорирования
railway station  —  вокзал
post office  —  почта
car rental  —  прокат машин
one-way ticket  —  билет в одну сторону
travel agent  —  туристический агент
return ticket  —  билет в обе стороны
boarding pass  —  посадочный талон
window seat  —  место у окна
round trip  —  поездка туда и обратно
public transport  —  общественный транспорт
aisle seat  —  место в проходе
currency exchange  —  обмен валюты
shopping mall  —  торговый центр
information desk  —  стойка информации
hail a cab  —  ловить такси
to determine  —  определять
to investigate  —  исследовать
domain name  —  доменное имя
hard drive capacity  —  емкость жесткого диска
cloud storage  —  облачное хранилище
network setup  —  настройка сети
annoying situation  —  раздражающая ситуация
signal strength  —  сила сигнала
wi-fi router  —  wi-fi маршрутизатор
virtual private network  —  виртуальная частная сеть
closed network  —  закрытая сеть
wireless signal  —  беспроводный сигнал
to precisely measure  —  точно измерить
carbon dioxide  —  углекислый газ
population growth  —  рост населения
wind power  —  энергия ветра
solar power  —  солнечная энергия
global warming  —  глобальное потепление
short term  —  в ближайщем будущем
animal species  —  вид животных
natural resources  —  природные ресурсы
greenhouse gases  —  парниковые газы
to experience  —  испытать
solar panels  —  солнечные панели
renewable sources  —  возобновляемые источники
to be trapped  —  быть пойманным в ловушку
negative impact  —  негативное влияние
fix the problem  —  решить проблему
energy demand  —  потребность в энергии
future generations  —  будущие поколения
extinct species  —  вымерший вид
emissions reduce  —  сокращение выбросов
dairy products  —  молочные продукты
folic acid  —  фолиевая кислота
fruit juice  —  фруктовый сок
healthy eating  —  здоровое питание
whole grain  —  цельное зерно
skip breakfast  —  пропускать завтрак
portion size  —  размер порции
digestive problems  —  проблемы с пищеварением
nutritional needs  —  потребности в питании
bone density  —  плотность костной ткани
leafy vegetables  —  листовые овощи
core principle  —  основной принцип
stomach acid  —  желудочная кислота
key nutrients  —  ключевые питательные вещества
fibre intake  —  потребление клетчатки
unpasteurised milk  —  непастеризованное молоко
key point  —  ключевой пункт
wrap up  —  завершать
take part  —  принимать участие
visual aids  —  визуальные средства
body language  —  язык тела
main point  —  главный вопрос
flip chart  —  флипчарт
annual general meeting  —  годичное общее собрание
conference call  —  конференция по телефону
proxy vote  —  голосование по доверенности
video conference  —  видеоконференция
summit talks  —  переговоры на высшем уровне
confidential talks  —  конфиденциальные переговоры
bilateral talks  —  двусторонние переговоры
round table talks  —  переговоры за круглым столом
plenary meeting  —  пленарное заседание
deep understanding  —  глубокое понимание
mutual understanding  —  взаимопонимание
attend a meeting  —  посещать собрание
item of the agenda  —  пункт повестки дня
top-level talks  —  переговоры на высшем уровне
arrive at a decision  —  принять решение
closing remarks  —  заключительное слово
adopt the agenda  —  принять повестку дня
advance a proposal  —  внести предложение
approve a proposal  —  одобрить предложение
arrive at a conclusion  —  приходить к заключению
come to a conclusion  —  приходить к выводу
conduct a conference  —  проводить конференцию
conduct a meeting  —  проводить собрание
conduct negotiations  —  вести переговоры
face a question  —  столкнуться с вопросом
convene a conference  —  созывать совещание
disapprove a proposal  —  отклонять предложение
hold negotiations  —  вести переговоры
interrupt negotiations  —  прерывать переговоры
reject a proposal  —  отклонять предложение
resume negotiations  —  возобновлять переговоры
solve a question  —  решать вопрос
mutual interest  —  взаимный интерес
elect a Chairman  —  выбирать председателя
a show of hands  —  голосование поднятием руки
in the course of a discussion  —  в ходе обсуждения
hot pepper  —  острый или жгучий перец, перец стручковый
thin crust  —  тонкая корочка
garlic bread  —  чесночный хлеб
free delivery  —  бесплатная доставка
I’d like to  —  Я бы хотел
order four pizzas  —  заказать четыре пиццы
regular crust  —  обычная корочка
soft drinks  —  безалкогольные напитки
main course  —  основное блюдо
wine list  —  винная карта
book a table  —  заказать столик в ресторане
table for two  —  столик на двоих
Indian summer  —  бабье лето
heat wave  —  период сильной жары
weather forecast  —  прогноз погоды
flash flood  —  ливневый паводок
cold snap  —  кратковременное похолодание
dust storm  —  пыльная буря
pouring rain  —  проливной дождь
below zero  —  ниже нуля
wet snow  —  мокрый снег
thick fog  —  густой туман
above zero  —  выше нуля
air pressure  —  атмосферное давление
deep snow  —  глубокий снег
heavy snow  —  сильный снегопад
forest fire  —  лесной пожар
freezing rain  —  ледяной дождь
cold front  —  холодный фронт
warm front  —  тёплый фронт
prevailing wind  —  преобладающий ветер
wind chill factor  —  коэффициент охлаждения ветром
severe weather warning  —  штормовое предупреждение
rhetorical question  —  риторический вопрос
short story  —  короткий рассказ, новелла
epic poem  —  эпическое стихотворение, эпос
blood pressure  —  артериальное давление
blood test  —  анализ крови
heart attack  —  сердечный приступ
catch a cold  —  простужаться
runny nose  —  насморк
sore throat  —  больное горло
urine test  —  анализ мочи
whooping cough  —  коклюш
nervous breakdown  —  нервное расстройство
cardiac arrest  —  остановка сердца
incurable disease  —  неизлечимая болезнь
back pain  —  боль в спине
varicose veins  —  варикозное расширение вен
adam's apple  —  адамово яблоко
index finger  —  указательный палец
ring finger  —  безымянный палец
little finger  —  мизинец
middle finger  —  средний палец
big toe  —  большой палец на ноге
little toe  —  мизинец на ноге
upper arm  —  плечо
small intestine  —  тонкая кишка
brown eyes  —  карие глаза
green eyes  —  зеленые глаза
large intestine  —  толстая кишка
blue eyes  —  голубые глаза
laugh your head off  —  смеяться до упаду
sense of humor  —  чувство юмора
time lapse  —  в замедленном темпе
most viewed  —  с наибольшим количеством просмотров
zero out  —  обнулять
zoom out  —  уменьшить масштаб
technical support  —  техническая поддержка
system administrator  —  системный администратор
operating system  —  операционная система
Pop-up menu  —  всплывающее меню
last modified  —  последний раз изменено: (дата)
read only  —  предназначенный только для чтения
address book  —  адресная книга
give feedback  —  осуществлять обратную связь
scroll bar  —  полоса прокрутки
database administrator  —  администратор базы данных
zoom in  —  увеличить масштаб
user name  —  имя пользователя
add to list  —  добавлять в список
Data source  —  источник данных
Command line  —  командная строка
data transfer  —  передача данных
File name  —  имя файла
system manager  —  системный администратор
data storage  —  накопление данных
Virtual memory  —  виртуальная память
Initial size  —  исходный размер
web hosting  —  хостинг
Mark as read  —  отметить как прочитанное
change directory  —  изменить каталог
Available format  —  доступный формат
in the morning  —  утром
in time  —  вовремя
once in a while  —  время от времени
every day  —  каждый день
at night  —  ночью
by the time  —  к этому времени
in the afternoon  —  днем
in the evening  —  вечером
on Saturday  —  в субботу
the other day  —  на днях
in winter  —  зимой
in summer  —  летом
in spring  —  весной
in autumn  —  осенью
every other day  —  через день
at noon  —  в полдень
last year  —  прошлый год
at midnight  —  в полночь
in two days  —  через два дня
the day after tomorrow  —  послезавтра
at present  —  в настоящее время
last month  —  прошлый месяц
last week  —  прошлая неделя
the day before yesterday  —  позавчера
in May  —  в Мае
at breakfast  —  за завтраком
in January  —  в январе
by this time  —  к этому времени
on weekdays  —  в будние дни
on Monday  —  в понедельник
at the weekend  —  в выходные
every week  —  каждую неделю
every month  —  каждый месяц
every year  —  каждый год
on Friday  —  в пятницу
after midnight  —  после полуночи
on Mondays  —  по понедельникам
on Sunday  —  в воскресенье
at the moment  —  в данный момент
by Friday  —  к пятнице
at five o'clock  —  в пять часов
by lunchtime  —  к обеду
ten years ago  —  десять лет назад
until October  —  до октября
be opposed to  —  выступающий против чего-либо
accustomed to  —  привычный к
lemon grass  —  лимонная трава
green beans  —  зелёностручковая фасоль
garden radish  —  редис
brussels sprout  —  брюссельская капуста
chili pepper  —  перец чили
root vegetable  —  корнеплод
bean sprouts  —  ростки бобов
red cabbage  —  краснокочанная капуста
cayenne pepper  —  кайенский перец
red pepper  —  красный перец
sweet potato  —  сладкая картошка
soy beans  —  соевые бобы
green pepper  —  зеленый перец
black beans  —  лобия
butternut squash  —  мускатная тыква
savoy cabbage  —  савойская капуста
water chestnut  —  водяной орех
white radish  —  белый редис
winter melon  —  зимняя дыня
platform shoes  —  обувь на платформе
trench coat  —  тренч
fur coat  —  шуба
bow tie  —  галстук-бабочка
baseball cap  —  бейсболка
leather jacket  —  кожаный пиджак
ball gown  —  бальное платье
dinner jacket  —  смокинг
evening gown  —  вечернее платье
bathing suit  —  купальный костюм
running shoes  —  кроссовки
wellington boots  —  резиновые сапоги
tennis shoes  —  обувь для тенниса
pleated skirt  —  юбка в складку
pointe shoes  —  пуанты
turtleneck sweater  —  водолазка
casual dress  —  повседневная одежда
ski boots  —  лыжные ботинки
hiking boots  —  треккинговые ботинки
polo shirt  —  поло
tweed jacket  —  твидовый пиджак
white tie  —  парадный костюм
court shoes  —  туфли-лодочки
bowling shoes  —  обувь для боулинга
riding boots  —  сапоги для верховой езды
ankle boot  —  полусапожки
Bermuda shorts  —  бермуды
stiletto heels  —  туфли на шпильках
beach shoes  —  пляжная обувь
cowboy boots  —  ковбойские сапоги
golf shoes  —  туфли для гольфа
army boots  —  армейские ботинки
ugli fruit  —  агли фрукт
star fruit  —  карамбола
rose hips  —  плоды шиповника
kiwi fruit  —  киви
juniper berry  —  можжевеловая ягода
goji berries  —  ягоды годжи
dragon fruit  —  питайя
cape gooseberry  —  физалис
bird cherry  —  черемуха
acai berry  —  асаи
tap water  —  водопроводная вода
strong drink  —  крепкий напиток
black coffee  —  черный кофе
sparkling water  —  газированная вода
soft drink  —  безалкогольный напиток
whipped cream  —  взбитые сливки
black tea  —  чёрный чай
ice cubes  —  кубики льда
mulled wine  —  глинтвейн
ginger ale  —  имбирный эль
orange juice  —  апельсиновый сок
mint tea  —  мятный чай
bottled water  —  бутилированная вода
tomato juice  —  томатный сок
herbal tea  —  травяной чай
alcoholic drink  —  алкогольный напиток
earl grey  —  эрл грей
hot chocolate  —  горячий шоколад
apple juice  —  яблочный сок
drinking water  —  питьевая вода
pineapple juice  —  ананасовый сок
scented tea  —  ароматизированный чай
hot toddy  —  горячий пунш
fruit drink  —  морс
lemon juice  —  лимонный сок
hot beverages  —  горячие напитки
chamomile tea  —  ромашковый чай
ice tea  —  чай со льдом
Irish coffee  —  кофе по-ирландски
cranberry juice  —  клюквенный сок
fresh squeezed  —  свежевыжатый
strawberry juice  —  клубничный сок
mango juice  —  манговый сок
ice coffee  —  глясе
ginger tea  —  имбирный чай
hot cocoa  —  горячее какао
non-alcoholic drink  —  безалкогольный напиток
apple cider  —  яблочный сидр
jasmine tea  —  жасминовый чай
banana smoothie  —  банановый смузи
masala chai  —  чай со специями
spiced tea  —  пряный чай
hibiscus tea  —  каркаде
ginger wine  —  имбирное вино
orange smoothie  —  апельсиновый смузи
vanilla latte  —  ванильное латте
bottled drinks  —  бутилированные напитки
caramel macchiato  —  карамельный маккиато
butter tea  —  тибетский чай
peach tea  —  персиковый чай
strawberry lemonade  —  клубничный лимонад
blueberry juice  —  черничный сок
fruit syrups  —  фруктовые сиропы
fruit nectars  —  фруктовые нектары
cocoa with marshmallows  —  какао с маршмэллоу
cranberry punch  —  клюквенный пунш
white hot chocolate  —  белый горячий шоколад
chocolate cappuccino  —  шоколадный капучино
mandarin juice  —  мандариновый сок
cherry syrup  —  вишневый сироп
vanilla syrup  —  ванильный сироп
dutch oven  —  большая чугунная кастрюля
food processor  —  кухонный комбайн
cake pan  —  форма для выпечки
gravy boat  —  соусник
salt shaker  —  солонка
salad bowl  —  салатник
ice pick  —  пестик для колки льда
measuring cup  —  мерная чашка
cutting board  —  разделочная доска
garlic press  —  чеснокодавилка
can opener  —  консервный нож
pepper pot  —  перечница
tea cup  —  чайная чашка
soup bowl  —  супница
bottle opener  —  открывалка
hot plate  —  нагревательная плита
cookie cutter  —  форма для печенья
knife sharpener  —  точилка для ножей
coffee grinder  —  кофемолка
pepper grinder  —  мельница для перца
mortar and pestle  —  ступка и пестик
ice bucket  —  ведерко со льдом
waffle iron  —  вафельница
measuring spoon  —  мерная ложка
meat tenderizer  —  молоток для отбивания мяса
sauce pan  —  кастрюля
egg timer  —  таймер для варки яиц
cookie sheet  —  противень
rice cooker  —  рисоварка
espresso machine  —  эспрессо-машина
baking dish  —  посуда для выпечки
fruit bowl  —  ваза для фруктов
ice cube tray  —  форма для льда
vegetable peeler  —  овощечистка
fondue set  —  набор для фондю
meat thermometer  —  термометр для мяса
honey dipper  —  ложка для мёда
cast iron pan  —  чугунная сковорода
 Май 2016: 6
wild strawberry  —  земляника
black currant  —  черная смородина
sweet cherry  —  черешня
white currant  —  белая смородина
black chokeberry  —  черноплодная рябина
standup comedy  —  стендап-комедия
look through  —  просматривать
get rid of  —  избавляться
hurry up  —  спешить
insist on  —  настаивать на чём-либо
focus on  —  концентрироваться, сосредотачиваться на
be supposed to  —  предполагается, что
be exposed to  —  подвергаться
look forward to  —  ждать с нетерпением
make up  —  придумывать
stand out  —  выделяться
take into account  —  брать во внимание
academic drama  —  академическая драма
beginning rhyme  —  начальная рифма
black comedy  —  чёрная комедия
blank verse  —  белый стих
caudate sonnet  —  хвостатый сонет
chivalric romance  —  рыцарский роман
closet drama  —  пьеса для чтения
commonplace book  —  блокнот для выписки литературных цитат с комментариями владельца
decasyllabic verse  —  десятисложный стих
detective story  —  детективный роман
dime novel  —  бульварный роман
double rhyme  —  двойная рифма
dramatic irony  —  скрытая ирония
epic poetry  —  эпическая поэзия
epistolary novel  —  эпистолярный роман
folk drama  —  народная драма
gothic novel  —  готический роман
romance novel  —  любовный роман
variable syllable  —  переменный слог
comic opera  —  комическая опера
run behind  —  опаздывать
run into  —  встречать (случайно)
hang around  —  бродить вокруг; околачиваться, шляться, слоняться
turn out  —  выворачивать (карманы), гасить, оказываться
come up  —  подниматься, подходить, приближаться
look forward to  —  ожидать с нетерпением
come on  —  давай!, пошли!, брось!, проходить, приходить, приближаться
go on  —  продолжать(ся); происходить
break up  —  прекращать, расставаться, расходиться
come by  —  заходить, заглядывать
come across  —  быть понятным, доходить, передавать (какое-л. чувство)
come along  —  сопровождать кого-л. / идти с кем-л., делать успехи
go down  —  понижаться, уменьшаться
grow up  —  созревать; становиться взрослым; взрослеть
wind up  —  сматывать, заводить, доводить до конца, злить, дразнить
hold on  —  держаться, упорствовать в чём-л., не сдаваться
come in  —  входить (в дом), входить в моду, участвовать, играть определённую роль
keep up  —  продолжать, поддерживать
get along  —  уживаться, ладить, справляться с делами
get in  —  пройти на выборах, поступить (в учебное заведение)
come out  —  приезжать, выезжать, бывать на людях
set up  —  устанавливать, основывать, планировать
carry out  —  выполнять, осуществлять (приказ и т.д.)
work out  —  решать, разрабатывать, быть успешным
put out  —  выгонять; устранять, тушить
take over  —  принимать (обязанности) от другого, вступать во владение
make out  —  понимать, разобраться в чем-л., составлять (документ), справляться
sit back  —  расслабляться, бездельничать
stand up  —  оставаться в рабочем состоянии, поддерживать (кого-л.), вставать
get away  —  выйти из трудного положения, взять отпуск
watch out  —  остерегаться, быть начеку
look out  —  быть настороже; выходить (на какую-либо сторону), быть обращённым (куда-л.)
run over  —  переливаться через край, сбить, переехать
get down  —  проглатывать (с трудом), подстрелить, сбивать с ног
put on  —  надевать, включать, приводить в действие
get over  —  справиться, понять, добраться до, перейти, перелезть
pull out  —  выдвигать идею, отходить (о поезде)
cut off  —  отрезать, отсекать, выключать
put up  —  строить, ставить (пьесу), повышать
take in  —  принимать (гостя); брать, понять; разобраться
stick out  —  высовываться; торчать, держаться до конца
go over  —  иметь успех, быть отложенным, переходить, принимать вид
show up  —  появляться, приходить
come back  —  возвращаться, вспоминаться, снова входить в моду
end up  —  закончить, дождаться
carry on  —  продолжать, продолжаться (о тексте), вести (дело)
turn down  —  отвергать, отклонять, убавлять, уменьшать
take out  —  вынимать, вытаскивать
fall down  —  падать, упасть, рухнуть
go out  —  выходить, бывать в обществе
turn around  —  изменить, перевернуть, подойти с другой стороны
give up  —  сдаться, отказаться, оставить, бросить
take up  —  обсуждать, занимать (место), заняться чем-либо
look for  —  искать, подыскивать, присматривать
pick up  —  поднимать, заезжать, заходить
switch off  —  выключать
figure out  —  вычислять, понимать, разгадывать, понимать
come over  —  заезжать, заходить (ненадолго)
pull off  —  отходить, отъезжать; снимать, убирать
fall off  —  падать, уменьшаться, ослабевать, ухудшаться
come off  —  покидать, уходить, удаляться
take back  —  отрекаться, отказываться (от сказанного), возвращать
hang up  —  повесить телефонную трубку
hold up  —  выставлять, показывать
shut down  —  отключить (электричество), остановить (машину и т. п.)
keep on  —  продолжать (делать что-л.)
run away  —  бежать, уклоняться от (чего-л.); избегать (чего-л.)
get up  —  подниматься, вставать (после сна)
move on  —  идти дальше; переходить к чему-либо
make up  —  составлять, сочинять, компенсировать, краситься
point out  —  указывать; показывать; обращать чьё-либо внимание, указывать
knock down  —  сломать, разрушить; снести (здание)
set off  —  отправляться (в путь)
go away  —  заканчиваться, прекращаться
get through  —  справиться; выдержать экзамен, провести (законопроект)
run out  —  кончаться, иссякать
wake up  —  просыпаться, будить кого-либо
find out  —  узнать, выяснить; раскрыть (тайну)
go off  —  выстреливать (об оружии), выключаться, ухудшаться
be up to  —  собираться, намереваться что-то сделать
blow up  —  начинать дуть; усиливаться (о ветре)
turn off  —  выключать ( газ); гасить (свет)
blow out  —  задувать, гасить, тушить (свечу)
turn on  —  включать (газ, радио, рубильник); зажигать, включать (свет)
hang on  —  упорствовать, ждать (у телефона)
catch up  —  схватить, подхватить, догнать
help out  —  помочь в затруднении, выручить
go in  —  начинать работу как обычно, участвовать, интересоваться,
go along  —  продвигаться; развиваться; сопровождаться (чем-л.)
sit down  —  садиться, усаживаться, занимать место
calm down  —  успокаиваться
knock off  —  сбавить (цену), быстро сделать, удержать (сумму)
get out  —  произнести, выведывать, уходить, сбегать
back away  —  отступать, отказываться
stand out  —  выделяться, быть заметным
get around  —  навещать, посещать; становиться известным
go through  —  быть одобренным, быть принятым (о проекте, предложении, законе)
hold out  —  иметь, питать (надежду), держаться до конца, требовать
go by  —  быть упущенным (о шансе), проходить (о времени)
move in  —  въезжать, поселяться
line up  —  выстраивать, становиться в линию, ряд, очередь
walk around  —  ходить, бродить повсюду
go back  —  возвращаться
come from  —  быть родом из
look back  —  вспоминать, оглядываться в прошлое
turn away  —  прогонять; не пускать, отклонять
go up  —  идти, ехать, увеличиваться, расти
walk over  —  без труда опередить соперников
let out  —  выпустить (о платье), проговориться
look over  —  тщательно изучать
pull up  —  останавливать (что-л.), останавливаться
put down  —  высаживать (пассажиров), прерывать (работу), записывать
turn into  —  превращаться
be up  —  проснуться, бодрствовать, подниматься
lie down  —  лечь, прилечь
break into  —  вламываться, ворваться
be out  —  отсутствовать, выйти из моды, заканчиваться
spread out  —  рассредоточиваться, планировать
work up  —  создавать, разрабатывать
put away  —  убирать, отложить, прятать
burst out  —  воскликнуть, разразиться (смехом и т.п.), вырваться
break in  —  вмешиваться в разговор, врываться, вламываться
break off  —  прекращать, порывать
pass out  —  терять сознание, раздавать, распределять
come down  —  уменьшаться, снижаться, рассматривать что-либо
settle down  —  успокоиться; установиться; поселиться
take away  —  убирать, забирать, отбирать, отнимать
walk up  —  подойти ближе
pull away  —  отъезжать, трогаться, отпрянуть, отстраниться
shut up  —  заставить замолчать
call back  —  перезвонить, позвать назад
throw up  —  бросать , отказываться от участия
break down  —  сломаться, потерпеть неудачу
cut out  —  вырезать, прекращать, пресекать
take on  —  приобретать, принимать (форму, вид и т.п.), брать (работу), иметь успех
set down  —  поставить, положить
write down  —  записывать, излагать письменно
run off  —  удирать, убегать, сбегать
turn over  —  переворачиваться, передавать
break out  —  вырваться, вспыхивать, разразиться
get back  —  вернуться
sit up  —  приподняться, садиться
walk out  —  выходить, отказаться участвовать
turn up  —  появляться, случаться
move out  —  съезжать, выдвигаться, выходить
stand by  —  приготовиться, ждать, поддерживать
shoot out  —  выдаваться вперёд, выставлять, выпалить
put in  —  подавать (заявление, жалобу), вводить (в действие), включать, добавлять
knock out  —  выбивать, вытряхивать, победить
turn back  —  возвращаться, поворачиваться назад
clean up  —  прибирать, приводить в порядок
go around  —  вращаться, вертеться (в голове), распространяться
be over  —  закончиться, пройти, перестать
back off  —  отступaть, отстать
look down  —  смотреть свысока на (кого-л.), быть расположенным выше (чего-л.)
be off  —  уходить, покидать; отправляться
run into  —  встретить, столкнуться, наскочить
come forward  —  выделяться, откликаться, отзываться
count on  —  рассчитывать на что-либо/кого-либо
switch on  —  включать (свет, радио), соединять абонента
pull on  —  натягивать
walk away  —  уходить
let in  —  допускать, признавать
walk in  —  входить (без ведома хозяев)
walk off  —  уходить, избавиться
freshen up  —  освежить, освежиться
divide by  —  делить на
up to  —  вплоть до
according to  —  в соответствии с, согласно
in addition to  —  в дополнение к
by means of  —  с помощью, посредством
in spite of  —  несмотря на, вопреки чему-либо
out of  —  из, вне, за
in front of  —  перед
as for  —  что касается
instead of  —  вместо
in case of  —  в случае
because of  —  из-за
in place of  —  вместо
fairy tale  —  сказка
role-playing game  —  ролевая игра
first floor  —  второй этаж (брит.)
double bed  —  двуспальная кровать
single bed  —  односпальная кровать
check in  —  зарегистрироваться в гостинице, регистрироваться, регистрироваться на рейс
check out  —  расплатиться и освободить номер в гостинице
in advance  —  заранее
hotel manager  —  управляющий гостиницей
pillow case  —  наволочка
half board  —  полупансион
front desk  —  стойка регистрации
full board  —  полный пансион
bed and breakfast  —  номер плюс завтрак, номер с завтраком
room service  —  обслуживание номеров
single room  —  одноместный номер
top floor  —  верхний этаж
hot tub  —  джакузи
adjoining rooms  —  два смежных номера гостиницы
indoor pool  —  закрытый бассейн
sea view  —  номер с видом на море
all Inclusive  —  "все включено"
workout room  —  тренажёрный зал
pay cash  —  расплатиться наличными
ice machine  —  автомат с кубиками льда
king-size bed  —  большая двуспальная кровать
rate includes  —  в стоимость включено
outside line  —  внешняя линия
queen size bed  —  двуспальная кровать без разделения посередине
twin room  —  двухместный номер с двумя кроватями, двухместный номер
pay for services  —  оплатить услуги
booking confirmation  —  подтверждение бронирования
safe deposit box  —  сейф для хранения ценностей
melt away  —  растаять, исчезнуть
high performance  —  высокая производительность
sign in  —  войти, зарегистрироваться
load balancing  —  балансировка нагрузки
Integrated Development Environment  —  интегрированная среда разработки
static variable  —  статическая переменная
programming language  —  язык программирования
query language  —  язык запросов
Local Area Network  —  локальная вычислительная сеть
Liquid-Crystal Display  —  жидкокристаллический индикатор
Lightweight Directory Applications Protocol 
протокол, обеспечивающий доступ к несовместимым между собой каталогам
leaf node  —  вершина дерева, не имеющая дочерних вершин
Light-Emitting Diode  —  светодиод
legal notes  —  юридическое заявление
LF Line Feed  —  перевод строки
Lesser GPL  —  стандартная общественная лицензия ограниченного применения
Last In First Out  —  последним пришёл - первым обслужен
line disciplines  —  протокол линии
line switching  —  коммутация каналов (линий связи)
line terminator  —  завершитель строки
links bar  —  панель ссылок
list headed by size  —  список с указанием размера
literate programming 
стиль разработки программы, при котором сначала пишется описание будущей программы на естественном языке, которое в процессе разработке разбавляется кодом программы
live CD  —  загрузочный компакт-диск
log file  —  журнал сообщений
look and feel  —  внешний вид, стиль
loopback interface  —  сетевая заглушка
loop body  —  тело цикла
low-level language  —  язык низкого уровня
Least Significant Bit  —  младший (наименее значащий) бит байта или машинного слова
Linux Security Modules  —  интерфейс модулей безопасности
hard disk  —  жесткий диск
distributed system  —  распределенная система
virtual synchrony  —  виртуальная синхронность
random number  —  случайное число
high availability  —  высока доступность
frying pan  —  сковорода, сковорода с ручкой
pressure cooker  —  скороварка, скороварка
pots and pans  —  кухонная посуда
rolling pin  —  скалка для теста, скалка
baking sheet  —  противень
coffee maker  —  кофеварка
sugar bowl  —  сахарница
drawing out  —  вытяжка
juice squeezer  —  соковыжималка
oven microwave  —  микроволновая печь
soft furniture  —  мягкая мебель
children's goods  —  детские товары
butter dish  —  маслёнка
salt cellar  —  солонка
tall wine glass  —  фужер
wine glass  —  рюмка
venetian blind  —  жалюзи
cold spell  —  похолодание
boiling hot  —  нестерпимо жаркий
heat stroke  —  тепловой удар
suntan lotion  —  лосьон для загара
below freezing  —  ниже нуля
freezing cold  —  очень холодный
partly cloudy  —  переменная облачность
ultra violet rays  —  ультрафиолетовые лучи
UV rays  —  ультрафиолетовые лучи
flight attendant  —  бортпроводник
shop assistant  —  продавец
police officer  —  полицейский
mail carrier  —  почтальон
taxi driver  —  таксист
sales representative  —  торговый представитель
motor mechanic  —  автомеханик
makeup artist  —  визажист
dog expert  —  кинолог
film director  —  кинорежиссёр
tax officer  —  налоговый инспектор
tax official  —  налоговый инспектор
notary public  —  нотариус
unskilled labourer  —  разнорабочий
odd-job man  —  разнорабочий
private tutor  —  репетитор
insurance agent  —  страховой агент
business representative  —  торговый представитель
pharmaceutical chemist  —  фармацевт
kindergarten teacher  —  воспитатель
vacuum cleaner  —  пылесос
dressing table  —  туалетный столик
washing machine  —  стиральная машина
TV set  —  телевизор
garbage can  —  мусорный бак
immersion heater  —  кипятильник
tape recorder  —  магнитофон
flower pot  —  горшок цветочный
blanket cover  —  пододеяльник
lighting facilities  —  осветительные устройства
electric fire  —  электрический камин
meat grinder  —  мясорубка
radio receiver  —  радиоприемник
video recorder  —  видеомагнитофон
turkish towel  —  махровое полотенце
sweep a floor  —  подметать пол
air freshener  —  освежитель воздуха
laundry hamper  —  корзина для белья
laundry basket  —  корзина для белья
water heater  —  колонка (водонагревательная)
electric lighter  —  электрозажигалка
facility heater  —  комнатный обогреватель
linen basket  —  корзина для белья
Department store  —  универмаг
set out  —  отправляться
get off  —  высаживаться, начинать, отбывать, отправляться
bus stop  —  автобусная остановка
take off  —  взлетать, снимать с себя, уходить, уезжать
get on  —  садиться, делать успехи, преуспевать
see off  —  провожать
that way  —  туда
shoe repair  —  ремонт обуви
service centre  —  сервисный центр
on vacation  —  отдыхать, быть на каникулах
touch down  —  приземляться
picture gallery  —  картинная галерея
double room  —  двухместный номер, номер на двоих
cross the street  —  перейти улицу
take a bus  —  сесть в автобус
dry cleaning  —  химчистка
left luggage  —  камера хранения
couple of blocks  —  пара кварталов
underground station  —  станция метро
railroad station  —  железнодорожная станция
train station  —  вокзал
get sunburnt  —  загорать
go abroad  —  поехать за границу
get a suntan  —  загорать
alight from  —  высаживаться
leave the ground  —  взлетать
polyjuice potion  —  оборотное зелье
Diagon Alley  —  Косой переулок
floo powder  —  Летучий порох
blood traitor  —  Предатель крови
chamber of secrets  —  тайная комната
Leaky Cauldron  —  Дырявый котел
the burrow  —  нора - дом, где живёт семейство Уизли
invisibility cloak  —  плащ-невидимка
deathly hallows  —  дары смерти
dark arts  —  тёмные искусства
death eater  —  пожиратель смерти
Room of Requirement  —  выручай комната
Forbidden Forest  —  Запретный Лес
Sorting Hat  —  Распределяющая Шляпа
Unbreakable Vow  —  нерушимый обет
Philosopher's Stone  —  философский камень
house elf  —  домовой эльф
The Daily Prophet  —  Ежедневный Пророк
Ministry of Magic  —  министерство магии
Hogwarts Express  —  хогвартс-экспресс
Platform Nine and Three-Quarters  —  платформу девять и три четверти
Dark Mark  —  чёрная метка
The Fat Lady  —  Полная Дама
The Marauder's Map  —  карта мародёров
Knight Bus  —  Автобус Ночной Рыцарь
great grandmother  —  прабабушка
great grandfather  —  прадед
granulated sugar  —  сахарный песок
mashed potatoes  —  картофельное пюре
processed cheese  —  плавленый сыр
red currant  —  красная смородина, Красная смородина
mineral water  —  минеральная вода
white coffee  —  кофе с молоком
sour cream  —  сметана
vegetable oil  —  растительное масло
white bread  —  белый хлеб
wheat bread  —  пшеничный хлеб
fried eggs  —  яичница
ground coffee  —  молотый кофе
instant coffee  —  растворимый кофе
condensed milk  —  сгущенное молоко
pike perch  —  судак
fried potatoes  —  жареный картофель
boiled egg  —  вареное яйцо
apple pie  —  яблочный пирог
rye bread  —  ржаной хлеб
crab stick  —  крабовая палочка
snail lobster  —  лангуст
collared beef  —  рулет мясной
cold-boiled pork  —  буженина
brown bread  —  черный хлеб
stale bread  —  чёрствый хлеб
stewed meat  —  тушеное мясо
fish dishes  —  рыбные блюда
fruit dessert  —  десерт из фруктов
sweet cherries  —  черешня
swiss cheese  —  швейцарский сыр
hard cheese  —  твёрдый сыр
soft cheese  —  мягкий сыр
blue cheese  —  сыр с плесенью
salty cheese  —  соленый сыр
green tea  —  зелёный чай
flavoured tea  —  ароматизированный чай
fruit tea  —  фруктовый чай
lemon tea  —  чай с лимоном
milk tea  —  чай с молоком
strong tea  —  крепкий чай
coffee seeds  —  кофе в зернах
decaffeinated coffee  —  кофе без кофеина
lump of sugar  —  кусочек сахара
sugar substitute  —  заменитель сахара
lime juice  —  лимонный сок
fresh bread  —  свежий хлеб
tomato sauce  —  томатный соус
bunch of grapes  —  кисть винограда
beef stew  —  рагу из говядины
canned fruit  —  консервированные фрукты
crab cherry  —  черешня
natural coffee  —  натуральный кофе
angry mood  —  злоба
brave heart  —  храброе сердце, смельчак, храбрец, бесстрашный человек